mimmmgffffffffff		gsgqljgmlfmfjgjo
mimmmgfgffffffff		gsgqljgqijhljqig
mimmmgfhffffffff		gsgqljiffihfkoij
mimmmgfiffffffff		gsgqljmhfihllomu
mimmmgfjffffffff		gsgqljlsjsllhigt
mimmmgfkffffffff		gsgqljlglsgtjsjq
mimmmgflffffffff		gsgqljjlfggfhqmg
mimmmgfmffffffff		gsgqljimhrkmkifo
mimmmgfnffffffff		gsgqljjqjngpgjhn
mimmmgfoffffffff		gsgqljilhlgsjshj
mimmmgfpffffffff		gsgqljirhjigkujj
mimmmgfqffffffff		gsgqljiqjghhmnmm
mimmmgfrffffffff		gsgqljkuhiknjmii
mimmmgfsffffffff		gsgqljgufofphgji
mimmmgftffffffff		gsgqljfohsiljpmj
mimmmgfuffffffff		gsgqljlphmmqifif
mimmmggfffffffff		gsgqljmofmlujmih
mimmmgggffffffff		gsgqljffknglfshj
mimmmgghffffffff		gsgqljfqlhknmugr
mimmmggiffffffff		gsgqljkmhjgpitig
mimmmggjffffffff		gsgqljlogthjjgjn
mimmmggkffffffff		gsgqljhmlsgghqli
mimmmgglffffffff		gsgqljlhfhfqgpjs
mimmmggmffffffff		gsgqljggiiktfsho
mimmmggnffffffff		gsgqljfrjkftlmjt
mimmmggoffffffff		gsgqljhfftgugffp
mimmmggpffffffff		gsgqljmkmphlkhlp
mimmmggqffffffff		gsgqljmgjiiskqit
mimmmggrffffffff		gsgqljkhlkgmlhhl
mimmmggsffffffff		gsgqljisgfjtiggf
mimmmggtffffffff		gsgqljlnmhhtlmmk
mimmmgguffffffff		gsgqljfmhlkffjjf
mimmmghfffffffff		gsgqljkqkkhhmtmn
mimmmghgffffffff		gsgqljknfgfpjgft
mimmmghhffffffff		gsgqljkglgfsfnmr
mimmmghiffffffff		gsgqljkljulikkhp
mimmmghjffffffff		gsgqljfuilmjmgmt
mimmmghkffffffff		gsgqljktkfiskmjq
mimmmghlffffffff		gsgqljfjfjmsmmji
mimmmghmffffffff		gsgqljgrlrhpgkfp
mimmmghnffffffff		gsgqljikipgtklml
mimmmghoffffffff		gsgqljjnmihshumt
mimmmghpffffffff		gsgqljhgfkiofris
mimmmghqffffffff		gsgqljfnlslhfqgo
mimmmghrffffffff		gsgqljgtfqhpjfgj
mimmmghsffffffff		gsgqljjsfjmsmsmg
mimmmghtffffffff		gsgqljfglphrmklh
mimmmghuffffffff		gsgqljfijfmnigkf
mimmmgifffffffff		gsgqljkimfgkkumh
mimmmgigffffffff		gsgqljmrljktlifn
mimmmgihffffffff		gsgqljgfmpiqioit
mimmmgiiffffffff		gsgqljholsmigsij
mimmmgijffffffff		gsgqljfpjhiolfkg
mimmmgikffffffff		gsgqljghhgmlkrlr
mimmmgilffffffff		gsgqljiggfgihmhs
mimmmgimffffffff		gsgqljmlfrgtkfhm
mimmmginffffffff		gsgqljjrfrfglngn
mimmmgioffffffff		gsgqljlqmpmsgllq
mimmmgipffffffff		gsgqljmsijmsggfh
mimmmgiqffffffff		gsgqljgpgnhnlglf
mimmmgirffffffff		gsgqljmtlqglmogm
mimmmgisffffffff		gsgqljioflkqkrkk
mimmmgitffffffff		gsgqljkplljkgfit
mimmmgiuffffffff		gsgqljgofliuhrgo
mimmmgjfffffffff		gsgqljiujomohokl
mimmmgjgffffffff		gsgqljhthpkohomk
mimmmgjhffffffff		gsgqljkolgjoiiln
mimmmgjiffffffff		gsgqljkkfnghgrko
mimmmgjjffffffff		gsgqljjpmshtgigo
mimmmgjkffffffff		gsgqljhljqktkimq
mimmmgjlffffffff		gsgqljjfhngrjgii
mimmmgjmffffffff		gsgqljgjgofrgnlq
mimmmgjnffffffff		gsgqljlmmqgqhlgh
mimmmgjoffffffff		gsgqljiijqlikuml
mimmmgjpffffffff		gsgqljhiitlhggkq
mimmmgjqffffffff		gsgqljinmlhfkfmj
mimmmgjrffffffff		gsgqljmigffogrhp
mimmmgjsffffffff		gsgqljgnkujuiukp
mimmmgjtffffffff		gsgqljjjihknmjgu
mimmmgjuffffffff		gsgqljmulligmfmr
mimmmgkfffffffff		gsgqljjimrfqjkhn
mimmmgkgffffffff		gsgqljipjrjlmmhl
mimmmgkhffffffff		gsgqljksiuiklmkn
mimmmgkiffffffff		gsgqljlimofoltip
mimmmgkjffffffff		gsgqljfhinfphnfk
mimmmgkkffffffff		gsgqljhpifjlknho
mimmmgklffffffff		gsgqljlumsgsjlhq
mimmmgkmffffffff		gsgqljithmktgulj
mimmmgknffffffff		gsgqljmqkjgmhkhg
mimmmgkoffffffff		gsgqljllfufokjii
mimmmgkpffffffff		gsgqljjmjqgullfn
mimmmgkqffffffff		gsgqljkrfsmsloho
mimmmgkrffffffff		gsgqljjgikksitgl
mimmmgksffffffff		gsgqljmjgrgnjhii
mimmmgktffffffff		gsgqljkjmjimmoir
mimmmgkuffffffff		gsgqljijjuhughmg
mimmmglfffffffff		gsgqljfsjkitjogp
mimmmglgffffffff		gsgqljlrfkfugugj
mimmmglhffffffff		gsgqljhhfqjhfljp
mimmmgliffffffff		gsgqljhsfnlfluhn
mimmmgljffffffff		gsgqljgsgrmmghih
mimmmglkffffffff		gsgqljjtlpmjhums
mimmmgllffffffff		gsgqljmmirgtkfin
mimmmglmffffffff		gsgqljlfjrmplqkj
mimmmglnffffffff		gsgqljfljllqljig
mimmmgloffffffff		gsgqljlkhqkngklm
mimmmglpffffffff		gsgqljkfjoffjjjp
mimmmglqffffffff		gsgqljhjjkklgrlq
mimmmglrffffffff		gsgqljhnjpikgrgt
mimmmglsffffffff		gsgqljjhjkkofjfi
mimmmgltffffffff		gsgqljjkgjikkpkl
mimmmgluffffffff		gsgqljhkijmlgnkt
mimmmgmfffffffff		gsgqljgilumpjngq
mimmmgmgffffffff		gsgqljmnjhglhigm
mimmmgmhffffffff		gsgqljmfhfkrhhju
mimmmgmiffffffff		gsgqljjohihkmuku
mimmmgmjffffffff		gsgqljhrfgiggiir
mimmmgmkffffffff		gsgqljlthhjimplt
mimmmgmlffffffff		gsgqljfkighhfpmp
mimmmgmmffffffff		gsgqljhufhgmfngs
mimmmgmnffffffff		gsgqljhqjkiqmgfr
mimmmgmoffffffff		gsgqljmpjtikjtkf
mimmmgmpffffffff		gsgqljftkpkpjlmp
mimmmgmqffffffff		gsgqljglkpmfkrmn
mimmmgmrffffffff		gsgqljgkipfnijhr
mimmmgmsffffffff		gsgqljljmsfjlogo
mimmmgmtffffffff		gsgqljihlsiqgqmu
mimmmgmuffffffff		gsgqljjujqloglis
