mimmmgmhffffffff		gsgqljmfhfkrhhju
mimmmgmhfgffffff		gsgqljmfmoihhjfu
mimmmgmhfhffffff		gsgqljmfmuhsfhfs
mimmmgmhfiffffff		gsgqljmffglrgifi
mimmmgmhfjffffff		gsgqljmfgukoitmh
mimmmgmhfkffffff		gsgqljmfhhgljrgq
mimmmgmhflffffff		gsgqljmfhqitlgjf
mimmmgmhfmffffff		gsgqljmfhimukrij
mimmmgmhfnffffff		gsgqljmflrhogumm
mimmmgmhfoffffff		gsgqljmfjqfogtko
mimmmgmhfpffffff		gsgqljmffkmfjimf
mimmmgmhfqffffff		gsgqljmfloklhomo
mimmmgmhfrffffff		gsgqljmfhjglkuii
mimmmgmhfsffffff		gsgqljmfkslqfmmk
mimmmgmhftffffff		gsgqljmfirklkkjq
mimmmgmhfuffffff		gsgqljmffignjnkp
mimmmgmhgfffffff		gsgqljmfkgflmrif
mimmmgmhggffffff		gsgqljmfmhfihrho
mimmmgmhghffffff		gsgqljmfltjihlhf
mimmmgmhgiffffff		gsgqljmfipiilnkf
mimmmgmhgjffffff		gsgqljmfglmrknis
mimmmgmhgkffffff		gsgqljmflsitkrhh
mimmmgmhglffffff		gsgqljmfkufulnkp
mimmmgmhgmffffff		gsgqljmffsjkfgjf
mimmmgmhgnffffff		gsgqljmfgjjslmlg
mimmmgmhgoffffff		gsgqljmfmlihiulo
mimmmgmhgpffffff		gsgqljmfjrfpmtgi
mimmmgmhgqffffff		gsgqljmfkphjimhs
mimmmgmhgrffffff		gsgqljmfmqgkhtgq
mimmmgmhgsffffff		gsgqljmfmflkfpgp
mimmmgmhgtffffff		gsgqljmffukqmnhr
mimmmgmhguffffff		gsgqljmfhpklhsim
mimmmgmhhfffffff		gsgqljmfmggjmjkn
mimmmgmhhgffffff		gsgqljmfjmmsgsip
mimmmgmhhhffffff		gsgqljmfgmmfgngi
mimmmgmhhiffffff		gsgqljmfluhihtfu
mimmmgmhhjffffff		gsgqljmflgmrgthf
mimmmgmhhkffffff		gsgqljmfgqhhftjn
mimmmgmhhlffffff		gsgqljmfinlfgjji
mimmmgmhhmffffff		gsgqljmfgtimgjjl
mimmmgmhhnffffff		gsgqljmfiqligngr
mimmmgmhhoffffff		gsgqljmflimqmght
mimmmgmhhpffffff		gsgqljmfijkufumg
mimmmgmhhqffffff		gsgqljmfkfhfkjkt
mimmmgmhhrffffff		gsgqljmfgnmufrkm
mimmmgmhhsffffff		gsgqljmffqgpgmft
mimmmgmhhtffffff		gsgqljmfjnhhjoho
mimmmgmhhuffffff		gsgqljmflnlljfkk
mimmmgmhifffffff		gsgqljmfgrhnglmt
mimmmgmhigffffff		gsgqljmfjphhjshs
mimmmgmhihffffff		gsgqljmfffisjqhu
mimmmgmhiiffffff		gsgqljmfhrkfmmjj
mimmmgmhijffffff		gsgqljmfiufnmufj
mimmmgmhikffffff		gsgqljmfjgfnilmh
mimmmgmhilffffff		gsgqljmfitfpfplp
mimmmgmhimffffff		gsgqljmflkhgkjhi
mimmmgmhinffffff		gsgqljmfjohpisml
mimmmgmhioffffff		gsgqljmffpkjfjhr
mimmmgmhipffffff		gsgqljmfkrmfguij
mimmmgmhiqffffff		gsgqljmfigllfjju
mimmmgmhirffffff		gsgqljmfjffijjji
mimmmgmhisffffff		gsgqljmfhlijkugq
mimmmgmhitffffff		gsgqljmfmmhhmtmu
mimmmgmhiuffffff		gsgqljmfllmqgkkj
mimmmgmhjfffffff		gsgqljmfgkhrirgm
mimmmgmhjgffffff		gsgqljmfiohnlgkn
mimmmgmhjhffffff		gsgqljmflphihgfu
mimmmgmhjiffffff		gsgqljmfkhifjsfr
mimmmgmhjjffffff		gsgqljmfjhjofrhf
mimmmgmhjkffffff		gsgqljmfhmgnfhhj
mimmmgmhjlffffff		gsgqljmfkqlkjtmk
mimmmgmhjmffffff		gsgqljmfmpltlmif
mimmmgmhjnffffff		gsgqljmfiijujsgt
mimmmgmhjoffffff		gsgqljmfknlsllhk
mimmmgmhjpffffff		gsgqljmfhklugojh
mimmmgmhjqffffff		gsgqljmffhhgjnll
mimmmgmhjrffffff		gsgqljmfflhrfmhf
mimmmgmhjsffffff		gsgqljmfjlhhjmlu
mimmmgmhjtffffff		gsgqljmfjjmqkugr
mimmmgmhjuffffff		gsgqljmfhtfhksmu
mimmmgmhkfffffff		gsgqljmflqhumilu
mimmmgmhkgffffff		gsgqljmfghkqggfk
mimmmgmhkhffffff		gsgqljmffjkrjffj
mimmmgmhkiffffff		gsgqljmfmnhlhmgo
mimmmgmhkjffffff		gsgqljmfgfmpjggm
mimmmgmhkkffffff		gsgqljmfmkgmfjkh
mimmmgmhklffffff		gsgqljmfftmslrjf
mimmmgmhkmffffff		gsgqljmfjsfuimjk
mimmmgmhknffffff		gsgqljmflfjhlnkm
mimmmgmhkoffffff		gsgqljmffnfjhpkk
mimmmgmhkpffffff		gsgqljmfkigugkgo
mimmmgmhkqffffff		gsgqljmfiskuguhk
mimmmgmhkrffffff		gsgqljmfjumkkjml
mimmmgmhksffffff		gsgqljmffolimrjq
mimmmgmhktffffff		gsgqljmfgomnluir
mimmmgmhkuffffff		gsgqljmfkmlillhf
mimmmgmhlfffffff		gsgqljmffmmpkkju
mimmmgmhlgffffff		gsgqljmfkkhmjpki
mimmmgmhlhffffff		gsgqljmfktipiuhm
mimmmgmhliffffff		gsgqljmfjifsgumn
mimmmgmhljffffff		gsgqljmfkjhlirfr
mimmmgmhlkffffff		gsgqljmfmjhghnhg
mimmmgmhllffffff		gsgqljmfmrflgugi
mimmmgmhlmffffff		gsgqljmfhgmhglmq
mimmmgmhlnffffff		gsgqljmfklhshlfr
mimmmgmhloffffff		gsgqljmfgslhjilh
mimmmgmhlpffffff		gsgqljmfljfmjfmk
mimmmgmhlqffffff		gsgqljmflmmtlpkf
mimmmgmhlrffffff		gsgqljmfhsmkhjgk
mimmmgmhlsffffff		gsgqljmfihmggfkm
mimmmgmhltffffff		gsgqljmfhuhhmmgu
mimmmgmhluffffff		gsgqljmfmtiuhkim
mimmmgmhmfffffff		gsgqljmffrfsjrgl
mimmmgmhmgffffff		gsgqljmfmimsgpmr
mimmmgmhmhffffff		gsgqljmfjkfhfsgm
mimmmgmhmiffffff		gsgqljmfifgrllmk
mimmmgmhmjffffff		gsgqljmfilmthimn
mimmmgmhmkffffff		gsgqljmfhnmqilkr
mimmmgmhmlffffff		gsgqljmfmsluhiig
mimmmgmhmmffffff		gsgqljmfhokihpft
mimmmgmhmnffffff		gsgqljmflhknhnih
mimmmgmhmoffffff		gsgqljmfkoltjkgh
mimmmgmhmpffffff		gsgqljmfgggkffjr
mimmmgmhmqffffff		gsgqljmfikiqikiu
mimmmgmhmrffffff		gsgqljmfgpgjhqlq
mimmmgmhmsffffff		gsgqljmfimmriuml
mimmmgmhmtffffff		gsgqljmfgihofqlr
mimmmgmhmuffffff		gsgqljmfjtifkrjl
